"filename", "language", "C", "C++", "Python", "Makefile", "comment", "blank", "total"
"d:\OneDrive - The University of Technology\PBL\PBL1\RSA\.mix\DemoFolder\demo.py", "Python", 0, 0, -10, 0, 32, 4, 26
"d:\OneDrive - The University of Technology\PBL\PBL1\RSA\.trash\decrypt.c", "C", 48, 0, 0, 0, 0, 6, 54
"d:\OneDrive - The University of Technology\PBL\PBL1\RSA\.trash\encrypt.c", "C", 132, 0, 0, 0, 0, 27, 159
"d:\OneDrive - The University of Technology\PBL\PBL1\RSA\.trash\genkey.c", "C", 160, 0, 0, 0, 0, 11, 171
"d:\OneDrive - The University of Technology\PBL\PBL1\RSA\.trash\genkey.h", "C++", 0, 468, 0, 0, 5, 49, 522
"d:\OneDrive - The University of Technology\PBL\PBL1\RSA\.trash\makefile", "Makefile", 0, 0, 0, 9, 0, 2, 11
"d:\OneDrive - The University of Technology\PBL\PBL1\RSA\.trash\outlog.c", "C", 178, 0, 0, 0, 40, 21, 239
"d:\OneDrive - The University of Technology\PBL\PBL1\RSA\.trash\outlog.h", "C++", 0, 26, 0, 0, 0, 5, 31
"d:\OneDrive - The University of Technology\PBL\PBL1\RSA\.trash\pythonTest.py", "Python", 0, 0, 19, 0, 0, 3, 22
"d:\OneDrive - The University of Technology\PBL\PBL1\RSA\Header\cmd.h", "C", -36, 0, 0, 0, -2, -9, -47
"d:\OneDrive - The University of Technology\PBL\PBL1\RSA\Header\int256.h", "C", -38, 0, 0, 0, 0, -16, -54
"d:\OneDrive - The University of Technology\PBL\PBL1\RSA\Header\outlog.h", "C++", 0, -26, 0, 0, 0, -5, -31
"d:\OneDrive - The University of Technology\PBL\PBL1\RSA\Header\pv.h", "C++", 0, -78, 0, 0, -1, -18, -97
"d:\OneDrive - The University of Technology\PBL\PBL1\RSA\Header\ui.h", "C", -13, 0, 0, 0, -2, -4, -19
"d:\OneDrive - The University of Technology\PBL\PBL1\RSA\Header\uilib.h", "C", -104, 0, 0, 0, -1, -14, -119
"d:\OneDrive - The University of Technology\PBL\PBL1\RSA\Source\cmd.c", "C", -603, 0, 0, 0, -2, -52, -657
"d:\OneDrive - The University of Technology\PBL\PBL1\RSA\Source\decrypt.c", "C", -32, 0, 0, 0, -11, -10, -53
"d:\OneDrive - The University of Technology\PBL\PBL1\RSA\Source\encrypt.c", "C", -115, 0, 0, 0, 0, -25, -140
"d:\OneDrive - The University of Technology\PBL\PBL1\RSA\Source\genkey.c", "C", -145, 0, 0, 0, -7, -12, -164
"d:\OneDrive - The University of Technology\PBL\PBL1\RSA\Source\int256.c", "C", -281, 0, 0, 0, -29, -31, -341
"d:\OneDrive - The University of Technology\PBL\PBL1\RSA\Source\launch.c", "C", -12, 0, 0, 0, 0, -2, -14
"d:\OneDrive - The University of Technology\PBL\PBL1\RSA\Source\main.c", "C", -26, 0, 0, 0, 0, -9, -35
"d:\OneDrive - The University of Technology\PBL\PBL1\RSA\Source\makefile", "Makefile", 0, 0, 0, -9, 0, -2, -11
"d:\OneDrive - The University of Technology\PBL\PBL1\RSA\Source\outlog.c", "C", -178, 0, 0, 0, -40, -21, -239
"d:\OneDrive - The University of Technology\PBL\PBL1\RSA\Source\pv.c", "C", -330, 0, 0, 0, -10, -34, -374
"d:\OneDrive - The University of Technology\PBL\PBL1\RSA\Source\rsa.c", "C", -115, 0, 0, 0, 0, -25, -140
"d:\OneDrive - The University of Technology\PBL\PBL1\RSA\Source\ui.c", "C", -258, 0, 0, 0, -43, -22, -323
"d:\OneDrive - The University of Technology\PBL\PBL1\RSA\Source\uilib.c", "C", -369, 0, 0, 0, -21, -47, -437
"d:\OneDrive - The University of Technology\PBL\PBL1\RSA\decrypt.c", "C", -48, 0, 0, 0, 0, -6, -54
"d:\OneDrive - The University of Technology\PBL\PBL1\RSA\header\cmd.h", "C", 37, 0, 0, 0, 1, 8, 46
"d:\OneDrive - The University of Technology\PBL\PBL1\RSA\header\int256.h", "C", 40, 0, 0, 0, 0, 19, 59
"d:\OneDrive - The University of Technology\PBL\PBL1\RSA\header\pv.h", "C++", 0, 100, 0, 0, 1, 19, 120
"d:\OneDrive - The University of Technology\PBL\PBL1\RSA\header\ui.h", "C", 13, 0, 0, 0, 2, 4, 19
"d:\OneDrive - The University of Technology\PBL\PBL1\RSA\header\uilib.h", "C", 104, 0, 0, 0, 1, 14, 119
"d:\OneDrive - The University of Technology\PBL\PBL1\RSA\launch.c", "C", 12, 0, 0, 0, 0, 2, 14
"d:\OneDrive - The University of Technology\PBL\PBL1\RSA\source\cmd.c", "C", 623, 0, 0, 0, 2, 52, 677
"d:\OneDrive - The University of Technology\PBL\PBL1\RSA\source\int256.c", "C", 303, 0, 0, 0, 28, 35, 366
"d:\OneDrive - The University of Technology\PBL\PBL1\RSA\source\main.c", "C", 26, 0, 0, 0, 0, 8, 34
"d:\OneDrive - The University of Technology\PBL\PBL1\RSA\source\pv.c", "C", 505, 0, 0, 0, 50, 54, 609
"d:\OneDrive - The University of Technology\PBL\PBL1\RSA\source\rsa.c", "C", 259, 0, 0, 0, 1, 34, 294
"d:\OneDrive - The University of Technology\PBL\PBL1\RSA\source\ui.c", "C", 258, 0, 0, 0, 43, 22, 323
"d:\OneDrive - The University of Technology\PBL\PBL1\RSA\source\uilib.c", "C", 369, 0, 0, 0, 21, 47, 437
"Total", "-", 364, 490, 9, 0, 58, 82, 1003