"filename", "language", "Makefile", "C", "C++", "comment", "blank", "total"
"d:\OneDrive - The University of Technology\PBL\PBL1\RSA\Header\cmd.h", "C++", 0, 0, 4, 0, 1, 5
"d:\OneDrive - The University of Technology\PBL\PBL1\RSA\Header\int256.h", "C", 0, 2, 0, 0, 0, 2
"d:\OneDrive - The University of Technology\PBL\PBL1\RSA\Header\prgvar.h", "C", 0, 13, 0, 0, 5, 18
"d:\OneDrive - The University of Technology\PBL\PBL1\RSA\Source\cmd.c", "C", 0, 78, 0, 0, 13, 91
"d:\OneDrive - The University of Technology\PBL\PBL1\RSA\Source\encrypt.c", "C", 0, -11, 0, 0, 0, -11
"d:\OneDrive - The University of Technology\PBL\PBL1\RSA\Source\genkey.c", "C", 0, 1, 0, 0, 0, 1
"d:\OneDrive - The University of Technology\PBL\PBL1\RSA\Source\int256.c", "C", 0, 38, 0, 0, 2, 40
"d:\OneDrive - The University of Technology\PBL\PBL1\RSA\Source\main.c", "C", 0, 1, 0, -1, -1, -1
"d:\OneDrive - The University of Technology\PBL\PBL1\RSA\Source\prgvar.c", "C", 0, 30, 0, -1, 3, 32
"d:\OneDrive - The University of Technology\PBL\PBL1\RSA\Source\ui.c", "C", 0, 39, 0, 1, 3, 43
"d:\OneDrive - The University of Technology\PBL\PBL1\RSA\Source\uilib.c", "C", 0, 3, 0, 0, 0, 3
"d:\OneDrive - The University of Technology\PBL\PBL1\RSA\decrypt.c", "C", 0, -8, 0, 0, -16, -24
"d:\OneDrive - The University of Technology\PBL\PBL1\RSA\makefile", "Makefile", -1, 0, 0, 0, 0, -1
"Total", "-", -1, 186, 4, -1, 10, 198